100 11 4
9 6 1 1 10 4 9 10 3 1 10 1 6 8 3 3 9 8
10 3 7 7 1 3 3 1 5 2 10 4 1 5 6 7 2 6
2 8 3 3 6 7 6 3 1 5 10 2 2 10 9 6 8 6
2 10 3 2 7 4 3 2 8 6 4 1 7 2 10 8 4 9
7 9 8 7 4 7 3 2 8 2 3 7 1 5 2 10 7 1 8
6 4 10 10 3 6 10 2 1